1111111111111
10010000001C1
1000011111111
1P0011E000001
111111111111